SO ./so.jpeg
WE ./we.jpeg
NO    ./no.jpeg
EA ./ea.jpeg

F	50, 0, 0
C 1,  30, 0


11111111111111111111111111111111111111111111111  
100000000011000000000000110000000110000010000001
111100000111000000000001100000011100000100000001
100100000000000000000000110000000000000000000001
11111111101100000101000001001111111111011000111
100000000011000001111101111111111110000000001101
111101111111111111000000100011111011110101111101
111101111111110111010100000011111011111111101101
11000000110101011110000010000100000001101010111
10000000100000001100000100011110000000100000001
100000000000000011010100100011000000000000000111
11000001110101011111111110011100000111010101111
11111111101000000000001111111111111101111100001
111111111111111111111111111111111111111110111111
1000000000000000000000001100000000011000001000001
1011000001110000000000001101100000111000001000011
10010000000000000000000011111111100100000010000001
1111111111110000010100000000000011111111110111001
1000000000110000011111011111111111000000000110001
1111011111111111110000001000111110011111111101111
1111011111111101110101000000111110111111111011101
1100000011010101111000001000111000000110101011111
10000000100000001100001000000100000001000000011001
1000000000000000110101001000110000000000000001101
11000001110101011111011110011100E00111010101111101
11111111101111111111111111111111111101111111111111
         1                          1





































