SO textures/grung.png
WE darkmetal.png
NO   textures/grung.png
EA darkmetal.png

F	10, 10, 10
C 80,  0, 0


        1111111111111111111111111        1111111111111111111111111         
        1000000000110000000000001        100000000110000010000001 
        1011000001110000000000001        1000000001110000010000001 
        1001000000000000000000001        1000000000000000000000001
111111111011000001010000010000001111111111011000111010000010000001
1000000000110000011111011111111111  100000000011000001111111111111111
11110111111111111100000010001111101111010110110000000100011
11110111111111011101010000001111101111111110110010100000011111111111111
110000001101010111100000100000000000011010101111000001S0000000000000001
10000000100000001100000100011110000000100000001000000100000000000000001
10000000000000001101010010001100000000000000011010100100000000000000001
11000001110101011111111110011100000111010101111101111001111111111111111
11111111 101000000000001111111111111 1011111000000011011
1111111111011111111111011           1101111111111111101111111  
1000000000000000000000001          1000000000110000010000001    
1011000001110000000000001         1011000001110000010000001   
10010000000000000000000011111111   100100000000000000000001111111
111111111011000001010000000000001111111111011100001010000010000001
100000000011000001111101111111111100000000011000001111101111111111
11110111111111111100000010001111100111111111011100000010001
1111011111111101110101000000111110111111111011101010000001
110000011101010111110111100111000001110101011111011110011
11111111 101111111111111111111111111 1011111111111111111
          1                           1