SO ./so.jpeg
WE ./we.jpeg
NO    ./no.jpeg
EA ./ea.jpeg

F	50, 0, 0
C 1,  30, 0
        1111111111111111111111111
        100000000011000000000001
        1011000001110000000000001
        1001000000000000000000011
11111111101100000111000000000001
1000E00000110000111011111111111
1100000011110101 1100000010001
1000000001 1000001111 000010001
11110111111111011100000010001
1000000000 0000001 101010010001
110000011101010111110111100111
11110111 1110101 101111010001
11111111 1111111 111111111111





















































