SO ./so.jpeg
WE ./we.jpeg
NO ./no.jpeg
EA ./ea.jpeg

F	50   ,     0   , 0
C	1 ,      10   ,         100

        1111111111111111111111111
		1000000000110000000000001
        1011000001110000000000001
        1001000000000000000000001
11111111101100000111000000000001
1000E000001100000111011111111111
11000000110101011100000010001 
100000000000001100000010001
11110111111111011100000010001
10000000000000001 101010010001
110000011101010111110111100111
11110111 1110101 101111010001
11111111 1111111 111111111111





















































